NO map_texture/textures/wood.xpm
SO map_texture/textures/eagle.xpm
WE map_texture/textures/redbrick.xpm
EA map_texture/textures/bluestone.xpm

C 120,80,0
F 20,240,255

1111111111111
1000000000001
100000N000001
1000000000001
1111111111111